000000000000000000000000000000000000000000000000000000000000
000000000000000000000000000000000000000000000000000000000000
000000000000000000000000000000000000000000000000000000000000
000000000000000000000000000000000000000000000000000000000000
000000000000000000000000111000011100000000000000000000000000
000000000000000000000010000000000000110000000000000000000000
000000000011100000001100000000000000000001000000000000000000
000001110000000011100000000000000000000000001110000000000000
000000000000000000000000000000000000000000000000000000000000
000000000000000000000000000000000000000000000000000000000000
111111111111111111111111111111111111111111111000000000000000
222222222222222222222222222222222222222222220000001110000000
222222222222222222222222222222222222222222220000000000000000
222222222222222222222222222222222222222222220000000000000000
222222222222222222222222222222222222222222222200000000110000
222222222222222222222222222222222222222222222220000000000000
222222222222222222222222222222222222222222222222000000001000
222222222222222222222222222222222222222222222222000000000000
222222222222222222222222222222222222222222222222000000000000
222222222222222222222222222222222222222222222222000000000000
